-------------X
-------------X
-------------X
-------------X
-------------X
-------------X
-------------X
-------------X
-------------X
-------------X
-------------X
-------------X
-----------BbX
-------------X
-------------X
-------------X
-------------X
----------E--X
-------------X
-------------X
-----?-------X
-----S----BbBX
-----S-------X
-------------X
-------------X
-------------X
-------------X
-------------X
-------------X
-----------BbX
-------------X
-------------X
---------Q-E-X
---------Q---X
---------Q---X
---------Q---X
-------------X
-------------X
-------------X
----------Bb-X
-------------X
-------------X
-------------X
-------------X
-------------X
----------E--X
-------------X
-------------X
-------------X
----------BbBX
-------------X
-------------X
-------------X
-------------X
-------------X
---------S---X
---------S---X
-------BbX---X
---------S---X
---------S---X
-------------X
-----------BbX
-------------X
-------------X
-------------X
-------------X
--------------
--------------
-------------X
----------<[[X
---------E>]]X
-------------X
-------------X
-------------X
-------------X
---------S---X
-----S---S---X
-----S--ES---X
-----S---S---X
-----S---S---X
----ES---S---X
-----S---S---X
-------------X
-------------X
-------------X
-------------X
-----S----<[[X
---------E>]]X
-------------X
-------------X
-------------X
-------------X
-------------X
-------------X
-------------X
-------------X
-------------X
-----------BbX
-------------X
-------------X
-------------X
-------------X
----------<[[X
---------E>]]X
-------------X
------------EX
-------------X
-------------X
-----------<[X
----------E>]X
-------------X
-------------X
-------------X
-------------X
-------------X
-----------BbX
-------------X
-------------X
-------------X
-------------X
-------------X
-----------<[X
----------E>]X
-------------X
-------------X
-------------X
-------------X
-----S---S---X
-----S--ES---X
-----S---S---X
-----S---S---X
-----S---S---X
-------------X
-------------X
----------XXXX
-------------X
-------------X
-------------X
-------------X
----------BbBX
-------------X
-------------X
--------S----X
--------S----X
--?----------X
--------------
------S-----XX
------S----XXX
----------XXXX
---------XXXXX
--------XXXXXX
-------XXXXXXX
-------------X
-------------X
-------------X
------------XX
-----------XXX
----------XXXX
---------XXXXX
--------XXXXXX
-------XXXXXXX
------XXXXXXXX
-----XXXXXXXXX
-----XXXXXXXXX
-------------X
-------------X
-------------X
-------------X
-------------X
-------------X
-------------X
-------------X
------------XX
-------------X
-------------X
-------------X
