-------------X
-------------X
-------------X
-------------X
-------------X
-------------X
-------------X
-------------X
-------------X
-------------X
------------EX
-------------X
-------------X
------------EX
-------------X
------------EX
------------EX
-------------X
-------------X
-------------X
-------------X
-------------X
-------------X
-------------X
------------EX
------------EX
-------------X
------------EX
-------------X
-------------X
-------------X
-------------X
-------------X
------------EX
-------------X
-------------X
-------------X
-------------X
-------------X
----------<[[X
---------E>]]X
-------------X
-------------X
-------------X
--------------
--------------
----------<[[X
---------E>]]X
-------------X
-------------X
-------------X
-------------X
----------E--X
-------------X
-------------X
-------------X
-------------X
-------------X
-------------X
------------EX
------------EX
------------EX
-------------X
-------------X
-------------X
-------------X
-------------X
-------------X
------------EX
------------EX
-------------X
------------EX
-------------X
-------------X
-------------X
-------------X
-------------X
-------------X
-------------X
---------EE--X
-------------X
-------------X
-------------X
-------------X
---------XXXXX
-----S---X---X
-----S---X---X
-----S---X----
---------X----
--------------
--------------
-------------X
-------------X
-------------X
-------------X
-------------X
-------------X
-------------X
------------EX
------------EX
-------------X
------------EX
-------------X
-------------X
-------------X
-------------X
-----------BbX
-------------X
-------------X
--------------
--------------
----------XXXX
-------------X
-------------X
-------------X
------------EX
------------EX
-------------X
------------EX
-------------X
-------------X
------------EX
-------------X
-------------X
-------------X
-------------X
-------------X
-------------X
------------EX
-------------X
-------------X
-------------X
-------------X
-------------X
-------------X
-------------X
-------------X
-------------X
-------------X
------------EX
-------------X
------------EX
---------XXXXX
---------S---X
---------S---X
---------S---X
-------------X
--------------
--------------
--------------
-------------X
-------<[X---X
------E>]X---X
-------------X
-----------BbX
-------------X
-------------X
-------------X
-----------<[X
----------E>]X
-------------X
-------------X
-------------X
-------------X
-------------X
-----------BbX
-------------X
-------------X
-------------X
-------------X
-------------X
----------E--X
-------------X
-------------X
-------------X
-------------X
----------E--X
------------XX
-----------XXX
----------XXXX
---------XXXXX
--------XXXXXX
-------------X
-------------X
-----XXXXXX--X
-----XXXXXX--X
-------------X
-------------X
-------------X
-------------X
-------------X
-------------X
-------------X
-------------X
------------XX
-------------X
-------------X
-------------X
