-------------X
-------------X
-------------X
-------------X
-------------X
-------------X
-------------X
-------------X
-------------X
-------------X
-------------X
-------------X
-------------X
-------------X
-------------X
-------------X
---------Q---X
-------------X
-------------X
-------------X
---------S---X
---------?--EX
-----Q---S---X
---------Q---X
---------S---X
-------------X
-------------X
-------------X
-----------<[X
----------->]X
-------------X
-------------X
-------------X
-------------X
-------------X
-------------X
-------------X
-------------X
----------<[[X
---------->]]X
-------------X
------------EX
-------------X
-------------X
-------------X
-------------X
---------<[[[X
--------->]]]X
-------------X
-------------X
-------------X
-------------X
-------------X
------------EX
-------------X
------------EX
-------------X
---------<[[[X
--------->]]]X
-------------X
-------------X
-------------X
-------------X
-------------X
--------S----X
-------------X
-------------X
-------------X
-------------X
--------------
--------------
-------------X
-------------X
-------------X
-------------X
-------------X
-------------X
---------S---X
---------?---X
-------E-S---X
-----S-------X
-----S-------X
----ES-------X
-----S-------X
-----S-------X
-----S-------X
-----S--------
-----S--------
--------------
-------------X
-------------X
-----S-------X
-----S-------X
-----S-------X
-----Q---S---X
------------EX
-------------X
------------EX
-------------X
-------------X
---------S---X
---------S---X
-------------X
-------------X
-------------X
-------------X
---------Q--EX
-------------X
-------------X
-----?---Q---X
-------------X
-------------X
---------Q---X
-------------X
-------------X
-------------X
-------------X
-------------X
---------S---X
-------------X
-------------X
-----S-------X
-----S-------X
-----S-------X
------------EX
------------EX
-------------X
------------EX
-----S-------X
-----Q---S--EX
-----Q---S---X
-----S-------X
-------------X
-------------X
------------XX
-----------XXX
----------XXXX
---------XXXXX
-------------X
-------------X
---------XXXXX
----------XXXX
-----------XXX
------------XX
-------------X
-------------X
-------------X
-------------X
------------XX
-----------XXX
----------XXXX
---------XXXXX
---------XXXXX
--------------
--------------
---------XXXXX
----------XXXX
-----------XXX
------------XX
-------------X
-------------X
-------------X
-------------X
-----------<[X
----------->]X
-------------X
-------------X
-------------X
---------S---X
---------S---X
---------Q---X
---------S---X
-------------X
-------------X
------------EX
------------EX
-------------X
-------------X
-------------X
-----------<[X
----------->]X
------------XX
-----------XXX
----------XXXX
---------XXXXX
--------XXXXXX
-------XXXXXXX
------XXXXXXXX
-----XXXXXXXXX
-----XXXXXXXXX
-------------X
-------------X
-------------X
-------------X
-------------X
-------------X
-------------X
-------------X
------------XX
-------------X
-------------X
-------------X
