-------------X
-------------X
-------------X
-------------X
-------------X
-------------X
-------------X
-------------X
-------------X
-------------X
-------------X
-------------X
-------------X
-------------X
------------EX
-------------X
------------EX
------------EX
-------------X
-------------X
-------------X
-------------X
-------------X
-------------X
-------------X
------------EX
-------------X
-------------X
---------<[[[X
--------E>]]]X
-------------X
-------------X
-------------X
-------------X
------------EX
-------------X
------------EX
-------------X
-------------X
--------------
-------------X
--------------
-------------X
-------------X
--------------
-------------X
-------------X
--------------
-------------X
-------------X
--------------
-------------X
------------EX
-------------X
-------------X
-------------X
-------------X
--------o----X
-------------X
-------------X
-------------X
-------------X
------------EX
------------EX
-------------X
------------EX
-------------X
-------------X
-------------X
---------<[[[X
--------E>]]]X
-------------X
-------------X
--------S----X
-------------X
----------<[[X
---------E>]]X
-------------X
-------------X
-------------X
-------------X
-------------X
--------o----X
-------------X
-------------X
-------------X
-------------X
---------<[[[X
--------E>]]]X
-------------X
-------------X
--------o----X
-------------X
-------------X
-------------X
-------------X
-------------X
---------<[[[X
--------E>]]]X
-------------X
------------EX
-------------X
----o-------EX
----o-------EX
-------------X
-------------X
-------------X
-------------X
-----------<[X
----------E>]X
-------------X
------------EX
-------------X
-------------X
-------------X
-------------X
-------------X
------------EX
-------------X
-------------X
-------------X
-------------X
------------EX
------------EX
-------------X
------------EX
-------------X
-------------X
-------------X
-------------X
-------------X
-------------X
-------------X
----------<[[X
---------E>]]X
-------------X
-------------X
-------------X
-------------X
-------------X
------------EX
-------------X
------------EX
------------EX
-------------X
-------------X
---------XXXXX
-----S-------X
-----S-------X
-----S-------X
-----S-------X
-----S---S---X
-----S-------X
-----S----E--X
-----S-------X
-------------X
---------XXXXX
-------------X
-------------X
-------------X
-------------X
-------------X
--------------
-------------X
----------E---
-------------X
-------------X
--------------
-----------E-X
--------------
-------------X
-------------X
--------------
-------------X
-------------X
-------------X
-------------X
--------S----X
--------S----X
--------S----X
--------S----X
--------S----X
--------S----X
--------S----X
--------S----X
-------------X
-------------X
-------------X
-------------X
-------------X
--------------
-------------X
--------------
-------------X
--------------
-------------X
-------------X
-------------X
-------------X
------------EX
------------EX
-------------X
-------------X
-----------XXX
-------------X
-------------X
-------------X
-------------X
-------------X
-------------X
-------------X
-------------X
-------------X
-------------X
--------------
--------------
--------o-----
--------o-----
--------------
--------------
-------------X
-------------X
-------------X
-------------X
-------------X
------------EX
------------EX
-------------X
------------EX
-------------X
--------------
----------<[[X
---------E>]]X
--------------
--------------
---------<[[[X
--------E>]]]X
--------------
--------------
--------<[[[[X
-------E>]]]]X
-------------X
-------------X
-------------X
-------------X
-------------X
-------------X
-------------X
-------------X
------------EX
------------EX
-------------X
------------EX
-------------X
-------------X
------------EX
-------------X
-------------X
-------------X
-------------X
-------------X
-------------X
-------------X
-------------X
-------------X
------------EX
-------------X
-------------X
------------XX
-----------XXX
----------XXXX
---------XXXXX
--------XXXXXX
-------XXXXXXX
-------------X
-------------X
--------o----X
--------o----X
-------------X
-------------X
-------------X
-------------X
-------------X
--------------
--------o-----
--------------
-------------X
-------------X
--------------
--------o-----
--------------
-------------X
-------------X
-------------X
-------------X
-------------X
-----------XXX
-------------X
------------EX
-------------X
-----------XXX
-------------X
-------------X
-------------X
-------------X
-------------X
-------------X
--------------
--------------
--------o-----
--------o-----
--------------
-------------X
--------------
--------o-----
--------o-----
--------------
-------------X
-------------X
-------------X
-------------X
-------------X
-------------X
-------------X
------------EX
-------------X
-------------X
-------------X
-------------X
-------------X
-------------X
------------EX
-------------X
------------EX
------------EX
-------------X
-------------X
----------<[[X
---------E>]]X
-------------X
-------------X
-------------X
-------------X
-------------X
-------------X
-------------X
-------------X
-------------X
-----------<[X
----------E>]X
-------------X
-------------X
--------------
-----------XXX
--------------
---------XXXXX
--------------
-------XXXXXXX
--------------
-----XXXXXXXXX
-----XXXXXXXXX
-------------X
-------------X
-------------X
-------------X
-------------X
-------------X
-------------X
-------------X
------------XX
-------------X
-------------X
-------------X
