-------------X
-------------X
-------------X
-------------X
-------------X
-------------X
-------------X
-------------X
-------------X
-------------X
-------------X
-------------X
-------------X
-------------X
----------<[[X
---------E>]]X
-------------X
-------------X
-----Q---?---X
-------------X
-------------X
-------------X
-------------X
-------------X
-------------X
--------------
--------------
-------------X
-------------X
-------------X
-------------X
-------------X
-------------X
-------------X
---------o---X
--------o----X
--------o----X
---------o---X
-------------X
-------------X
-------------X
-------------X
-------------X
-------------X
-------------X
-------------X
-------------X
-------------X
-------------X
-------------X
-------------X
-------------X
-------------X
-------------X
-------------X
-------------X
-------------X
-----Q---Q---X
-------------X
-----Q---Q---X
-------------X
-------------X
-------------X
-------------X
-------------X
-------------X
-------------X
-------------X
-------------X
-------------X
-------------X
--------------
--------------
--------------
--------------
-------------X
-------------X
-------------X
-------------X
-------------X
-------------X
-------------X
-------------X
---------Q---X
---------Q---X
-----S---Q---X
---------Q---X
-------------X
-------------X
-------------X
-------------X
-------------X
-------------X
-------------X
-------------X
-------------X
----------XXXX
-------------X
------o------X
------o------X
------o------X
------o------X
-------------X
-------------X
-------------X
-------------X
-------------X
-------------X
-------------X
---------<[[[X
--------E>]]]X
-------------X
------o------X
------o------X
------o------X
------o------X
-------------X
-------------X
-------------X
-------------X
-------------X
-------------X
-------------X
-------------X
-------------X
---------<[[[X
--------E>]]]X
-------------X
------o------X
------o------X
------o------X
------o------X
-------------X
-------------X
-------------X
-------------X
-------------X
-------------X
-------------X
---------Q---X
---------Q---X
-----Q---?---X
-----Q---S----
-----Q---S----
-----Q---Q---X
---------Q---X
---------Q---X
-------------X
-------------X
-------------X
-------------X
-------------X
-------------X
-------------X
-------------X
-------------X
-----------<[X
----------E>]X
-------------X
-------------X
-------------X
-------------X
-------------X
-------------X
-------------X
-------------X
-------------X
--------------
--------------
--------------
-------------X
-------------X
-------------X
--------------
--------------
-------------X
-------------X
-------------X
-------------X
-------------X
-------------X
-------------X
----------XXXX
--------------
--------------
-------------X
-------------X
-------------X
-------------X
-------------X
-------------X
-------------X
-------------X
-------------X
-------------X
-------------X
-------------X
-------------X
-------------X
-------------X
-------------X
------------XX
-----------XXX
----------XXXX
---------XXXXX
--------XXXXXX
-------XXXXXXX
------XXXXXXXX
-----XXXXXXXXX
-----XXXXXXXXX
-------------X
-------------X
-------------X
---------S---X
-------------X
-------------X
-------------X
-------------X
------------XX
-------------X
-------------X
-------------X
