-------------X
-------------X
-------------X
-------------X
-------------X
-------------X
-------------X
-------------X
---------S---X
---------?---X
---------S---X
-------------X
-------------X
------------XX
-----------XXX
----------XXXX
---------EXXXX
--------XXXXXX
-------------X
-------------X
-------------X
-----S---S---X
-----S------EX
-----S------EX
-----S-------X
-------------X
-------------X
---------XXXXX
-----------XXX
-------------X
-------------X
-------------X
------------EX
------------EX
-------------X
-------------X
-------------X
-------------X
-------------X
---------<[[[X
--------E>]]]X
-------------X
-------------X
-------------X
-------------X
---------E---X
-----Q---?---X
-----Q---Q---X
-----Q---Q---X
-----Q---Q---X
-----Q---Q---X
-------------X
------------EX
-------------X
------------EX
-------------X
-------------X
------------EX
-------------X
-------------X
------------EX
---------S--EX
-----S-------X
-----S------EX
-----S-------X
-----S-------X
-------------X
---------<[[[X
--------E>]]]X
-------------X
-------------X
-------------X
---------Q---X
---------Q---X
-----S---Q---X
-----S---Q---X
-----S------EX
-----S-------X
-----S---Q--EX
---------Q--EX
---------Q---X
-------------X
-------------X
-------------X
-------------X
-----S--------
-----S--------
-----S--------
-----S--------
-------------X
-------------X
-------------X
-------------X
------------EX
-------------X
-------------X
---------<[[[X
--------E>]]]X
-------------X
--------------
--------------
--------------
-------------X
-------------X
-------------X
-------------X
------------EX
-------------X
-----------<[X
----------E>]X
-------------X
-------------X
------------EX
-------------X
-------------X
---------<[[[X
--------E>]]]X
-------------X
-----?-------X
-----S----<[[X
-----S---E>]]X
-----S-------X
-------------X
--------<[[[[X
-------E>]]]]X
-------------X
-------------X
-------------X
-------------X
-------------X
-------------X
-------------X
--------------
--------------
--------------
-------------X
-------------X
-------------X
-------------X
-------------X
-------------X
-------------X
-------------X
-----------E-X
-------------X
--------------
--------------
----------XXXX
-------------X
-------------X
-------------X
-------------X
-------------X
------------EX
---------S--EX
-------------X
-------------X
-----S-------X
-----S---E---X
-----S-------X
-----S-------X
-----S-------X
-------------X
----------E--X
-------------X
-----?-------X
-------------X
-------------X
-------------X
----------<[[X
---------E>]]X
------------EX
-------------X
-------------X
-------------X
-------------X
-------------X
-------------X
---------S---X
-----S---S---X
-------------X
-------------X
-------------X
---XXXXXXXXXXX
---XXXXXXXXXXX
-------------X
-------------X
-------------X
-------------X
-------------X
-------------X
-------------X
-------------X
------------XX
-------------X
-------------X
-------------X
