-------------X
-------------X
-------------X
-------------X
-------------X
---------S---X
---------S---X
---------S---X
-------------X
-------------X
-------------X
-------------X
-------------X
-------------X
---------<[[[X
--------E>]]]X
-------------X
-------------X
-----S-------X
-----S---S---X
---o-S------EX
-------------X
-------------X
---------<[[[X
--------E>]]]X
-------------X
-------------X
------<[X----X
-----E>]X----X
--------X----X
-----------<[X
----------E>]X
-----------<[X
----------E>]X
-------------X
-------------X
-------------X
-------------X
-------------X
-------------X
-------------X
---------<[[[X
--------E>]]]X
-------------X
-------------X
-------------X
---------S---X
---------S---X
-------------X
-------------X
-------------X
--------<[[[[X
-------E>]]]]X
-------------X
-------------X
-------------X
-------------X
-------<[X---X
------E>]X---X
---------X---X
-------------X
-------------X
-----S-----<[X
-----S----E>]X
-----S-------X
-----S-------X
-----S-------X
-------------X
-------------X
-----------<[X
----------E>]X
-------------X
-----S-------X
-----S-------X
-----S-------X
-----S----<[[X
-----S---E>]]X
---------S---X
-------------X
-----------<[X
----------E>]X
-------------X
-------<[[[[[X
------E>]]]]]X
-------------X
-------------X
-------------X
-------------X
-------------X
----------<[[X
---------E>]]X
-------------X
-------------X
-------------X
-------------X
-------------X
-------------X
---------<[[[X
--------E>]]]X
-------------X
-----------<[X
----------E>]X
-------------X
-------------X
-------------X
---------S---X
------<[[X---X
-----E>]]X---X
---------S---X
-------------X
-----S-----<[X
----------E>]X
-------------X
-------------X
-----S-------X
-----S-------X
-----S-------X
-----S-------X
-----S--------
-----S--------
-----S--------
-----S--------
-----S--------
--------------
-------------X
-------------X
-----------<[X
----------E>]X
-------------X
-------------X
-----------<[X
----------E>]X
-------------X
--------S----X
--------S----X
-----S-------X
-----S--------
-------------X
--------------
---------S---X
-----S---S---X
-----S---S---X
-------------X
-------------X
------------XX
-----------XXX
----------XXXX
----------XXX-
----------<[[X
---------E>]]X
-------------X
---------XXXXX
---------XXXXX
-----------XXX
-------------X
-----S---S---X
-----S---S---X
-----S---S---X
-------------X
-------------X
-------------X
-------------X
------<[[X--EX
-----E>]]X---X
---------X---X
-------------X
-------------X
-------------X
-------------X
---------<[[[X
--------E>]]]X
-------------X
-------------X
-------------X
-----------<[X
----------E>]X
----------<[[X
---------E>]]X
---------<[[[X
--------E>]]]X
-------------X
-------------X
-------------X
-------------X
----------<[[X
---------E>]]X
-------------X
-------------X
-------------X
-------------X
-------------X
-------------X
-------------X
-------------X
------------XX
-----------XXX
---------<[[[X
-----E--E>]]]X
--------XXXXXX
-------XXXXXXX
------XXXXXXXX
-----XXXXXXXXX
-----XXXXXXXXX
-----XXXXXXXXX
-------------X
-------------X
-------------X
-------------X
-------------X
-------------X
-------------X
------------XX
------------XX
-------------X
-------------X
